....................
.........#..........
......####..........
......#.............
....................
....................
....................
.....#####..........
....................
....................
....................
....................
..............#.....
..............#.....
..............#.....
.....##########.....
....................
....................
....................
....................