....................
....................
....................
....................
.......#######......
.............#......
............##......
............#.......
....................
....................
######..............
#...................
#...................
#...................
....................
....................
....................
....................
....................
....................